82
8
21 2 0 0 0 0 0 0 0 0 0 0 0 0 0 0 0 0 0 0 0 0 0 0 0 0 0 0 0 0 0 0 0 0 0 0 0 0 0 0 0 0 0 0 0 0 0 0 0 0 0 0 0 0 0 0 0 0 0 0 0 0 0 0 0 0 0 0 0 3 22 4 0 0 18 22 22 22 22 22 22 22
22 4 0 0 0 0 0 0 0 0 0 0 0 0 0 0 0 0 0 0 0 0 0 0 0 0 0 0 0 0 0 0 0 0 0 0 0 0 0 0 0 0 0 0 0 0 0 0 0 0 0 0 0 0 0 0 0 0 0 0 0 0 0 0 0 0 0 0 0 3 22 4 0 0 0 18 22 22 22 22 22 22
22 4 0 0 0 0 0 0 0 0 0 0 0 0 0 0 0 0 0 0 0 0 0 0 0 0 0 0 0 0 0 0 0 0 0 0 0 0 0 0 0 0 0 0 0 0 0 0 0 0 0 0 0 0 0 0 0 0 0 0 0 0 0 0 0 0 0 1 21 3 22 4 0 0 0 0 18 22 22 22 22 22
22 4 0 0 0 0 0 0 0 0 0 0 0 0 0 0 0 0 0 0 0 0 0 0 0 0 0 0 0 0 0 0 0 0 0 0 0 0 0 0 0 0 0 0 0 0 0 0 0 0 0 0 0 0 0 0 0 0 0 0 0 0 0 0 0 0 1 21 21 3 22 4 0 0 0 0 0 18 22 22 22 22
22 4 0 0 0 0 0 0 0 21 0 0 0 0 0 21 0 0 0 0 0 0 0 0 0 0 0 0 0 0 0 0 21 21 21 21 21 21 21 21 0 0 0 0 0 0 0 0 0 0 0 0 0 0 0 0 0 0 0 0 0 0 0 0 0 1 21 21 21 3 22 4 0 0 0 0 0 0 18 22 22 22
22 4 0 0 0 0 0 0 21 21 0 0 0 0 26 21 21 0 0 0 0 0 0 0 0 0 0 0 0 0 27 0 21 21 21 21 21 21 21 21 0 0 0 0 0 0 0 0 21 21 21 0 0 0 21 21 21 0 0 0 21 21 21 0 1 21 21 21 21 3 22 4 0 0 0 0 0 0 0 18 22 22
22 4 0 0 0 0 0 21 21 21 21 21 21 21 21 21 21 21 0 0 0 0 0 0 21 21 21 21 21 21 21 21 21 21 21 21 21 21 21 21 0 9 0 0 10 0 26 11 21 21 21 0 27 0 21 21 21 0 26 0 21 21 21 0 21 21 21 21 21 0 17 0 0 0 0 0 0 0 0 0 18 22 
5 21 21 21 21 21 21 21 21 21 21 21 21 21 21 21 21 21 21 21 21 21 21 21 21 21 21 21 21 21 21 21 21 21 21 21 21 21 21 21 21 21 21 21 21 21 21 21 21 21 21 21 21 21 21 21 21 21 21 21 21 21 21 21 21 21 21 21 21 21 21 21 21 21 21 21 21 21 21 21 21 7
  
