82
8
21 22 22 22 22 0 0 0 0 0 0 22 0 0 0 0 0 0 0 0 22 0 0 0 0 0 0 0 0 0 22 0 0 0 0 0 0 0 0 0 0 0 0 0 0 0 22 0 0 0 0 0 0 0 22 0 0 0 0 0 0 0 0 0 0 0 0 0 0 3 22 4 0 0 18 22 22 22 22 22 22 22
22 22 22 22 22 0 0 0 0 0 0 22 0 0 0 0 0 0 0 0 22 0 0 0 0 0 0 0 0 0 22 0 0 0 0 0 0 0 0 0 0 0 0 0 0 0 22 0 0 0 0 0 0 0 22 0 0 0 0 0 0 0 0 0 0 0 0 0 0 3 22 4 0 0 0 18 22 22 22 22 22 22
22 22 22 22 22 0 0 0 0 0 0 22 0 0 0 0 0 0 0 0 22 0 0 0 0 0 0 0 0 0 22 0 0 0 0 0 0 0 0 0 0 0 0 0 0 0 22 0 0 0 0 0 0 0 22 0 0 0 0 0 0 0 0 0 0 0 0 1 21 3 22 4 0 0 0 0 18 22 22 22 22 22
22 22 22 22 22 0 0 0 0 0 0 22 0 0 0 0 0 0 0 0 22 0 0 0 0 0 0 0 0 0 22 0 0 0 0 0 0 0 0 0 0 0 0 0 0 0 22 0 0 0 0 0 0 0 22 0 0 0 0 0 0 0 0 0 0 0 1 21 21 3 22 4 0 0 0 0 0 18 22 22 22 22
22 28 22 22 22 0 0 0 0 0 0 22 0 0 0 0 0 0 0 0 22 0 0 0 0 0 0 0 0 0 22 0 0 0 0 0 0 21 0 0 0 0 0 0 0 0 22 0 0 0 0 0 0 0 22 0 0 0 0 0 0 0 0 0 0 1 21 21 21 3 22 4 0 0 0 0 0 0 18 22 22 22
22 0 22 22 22 0 0 0 0 0 0 22 0 0 0 0 0 0 0 0 22 0 0 0 0 21 0 0 0 0 22 0 0 0 0 0 21 29 0 0 0 0 0 0 0 0 22 0 0 0 0 0 0 0 22 0 0 0 0 0 0 0 0 0 1 21 21 21 21 3 22 4 0 0 0 0 0 0 0 18 22 22
22 0 0 0 0 0 0 0 0 0 0 22 0 0 0 0 0 0 0 0 27 0 0 0 0 22 0 0 0 0 22 0 0 0 0 21 21 21 0 0 27 0 0 0 0 0 22 0 0 0 0 0 0 0 22 0 0 0 0 0 0 0 0 0 21 21 21 21 21 0 17 0 0 0 0 0 0 0 0 0 18 22 
5 21 21 21 21 21 21 21 21 21 21 21 21 21 21 21 21 21 21 21 21 21 21 21 21 21 21 21 21 21 21 21 21 21 21 21 21 21 21 21 21 21 21 21 21 21 21 21 21 21 21 21 21 21 21 21 21 21 21 21 21 21 21 21 21 21 21 21 21 21 21 21 21 21 21 21 21 21 21 21 21 7
  
 