82
8
21 2 0 0 0 0 0 0 0 0 0 0 0 0 0 0 0 0 0 0 0 0 0 0 0 0 0 0 0 0 0 0 0 0 0 0 0 0 0 0 0 0 0 0 0 0 0 0 0 0 0 0 0 0 0 0 0 0 0 0 0 0 0 0 0 0 0 0 0 3 22 4 0 0 18 22 22 22 22 22 22 22
22 4 0 0 0 0 0 0 0 0 0 0 0 0 0 0 0 0 0 0 0 0 0 0 0 0 0 0 0 0 0 0 0 0 0 0 0 0 0 0 0 0 0 0 0 0 0 0 0 0 0 0 0 0 0 0 0 0 0 0 0 0 0 0 0 0 0 0 0 3 22 4 0 0 0 18 22 22 22 22 22 22
22 4 0 0 0 0 0 0 0 0 0 0 0 0 0 0 0 0 0 0 0 0 0 0 0 0 0 0 0 0 0 0 0 0 0 0 0 0 0 0 1 21 8 21 2 0 0 0 0 0 0 0 0 0 0 0 0 0 0 0 0 0 0 0 0 0 0 1 21 3 22 4 0 0 0 0 18 22 22 22 22 22
22 4 0 0 0 0 0 0 0 0 0 0 0 0 0 0 0 0 0 0 0 0 0 0 0 0 0 0 0 0 0 0 0 0 0 0 0 0 0 26 3 22 8 22 4 0 0 0 0 0 0 0 0 0 0 0 0 0 0 0 0 0 0 0 0 0 1 21 21 3 22 4 0 0 0 0 0 18 22 22 22 22
22 4 0 0 0 0 0 0 0 0 0 0 0 1 21 2 0 0 0 0 0 0 0 0 0 0 0 0 0 0 0 0 1 21 2 0 23 24 24 24 24 25 0 23 24 24 24 24 24 24 24 24 24 24 24 25 0 0 0 0 0 0 0 0 0 1 21 21 21 3 22 4 0 0 0 0 0 0 18 22 22 22
22 4 0 0 0 0 0 0 0 0 0 0 1 21 21 2 0 0 0 0 0 0 0 0 1 21 2 0 0 0 0 1 21 21 2 0 0 0 0 0 0 0 0 0 0 0 0 0 0 0 0 0 0 0 0 0 0 0 0 0 0 0 0 0 1 21 21 21 21 3 22 4 0 0 0 0 0 0 0 18 22 22
22 4 0 9 1 21 2 1 21 2 0 1 21 21 21 2 0 0 0 0 0 0 27 0 3 22 4 0 0 0 1 21 21 21 2 0 0 0 0 0 0 9 0 0 10 0 0 11 0 0 0 9 0 0 0 10 0 0 0 0 0 0 0 1 21 21 21 21 21 0 17 0 0 0 0 0 0 0 0 0 18 22 
5 21 21 21 21 21 21 21 21 21 21 21 21 21 21 21 21 21 21 21 21 21 21 21 21 21 21 21 21 21 21 21 21 21 21 21 21 21 21 21 21 21 21 21 21 21 21 21 21 21 21 21 21 21 21 21 21 21 21 21 21 21 21 21 21 21 21 21 21 21 21 21 21 21 21 21 21 21 21 21 21 7